1111111111111
1001000000100
10000111011111
1P0011E000111
1111111111111