111111111111111111111111111111111111111111111111111111
1E0000000000000C00000C0000000000000C00000C000000000001
1010010100100000000C00000C0000000000101001000000010101
1010010010101010001000C000C000010C00000001000000010101
10100101001000000C00000C00000C00000C000000010100100101
1010010010101010001000001000000000C00000C0000000100001
1010010100100000000C00000C000C00000C0000C0000000100001
101001001010101000100000C00000C0000000C00000C000010101
1010010100100000000C00000C000000C000C00101000000010101
101001001010101000100000C00000C000000C00000C00000C0101
1P0000000C00C0000000000C00000C000000C000000000000000C1
111111111111111111111111111111111111111111111111111111