1111111111111
1001001000EC1
10E0110000001
1001000001001
1111111111111