1111111111111
1001000000100
1000011101111
1P0011E000111
1111111111111