1111111111111
100100000G101
1000011101111
1P0011E000111
1111111111111