1111111111111
10010000000C1
1P0011E000001
100100000C  1
1111111111110